[info]
32
map2_tileset.png
[tiles]
#,Grass,0
&,Lava,1
1,Tree,1
2,Water,1
[map]
###################################################################################################################
###################################################################################################################
###################################################################################################################                                                                           
###################################################################################################################
###################################################################################################################
###################################################################################################################
###################################################################################################################
#####################&&&&&&&&&&&&&&&&&&&&&&&&&&&&&&&&&&############################################################
#####################&&&&&&&&&&&&&&&&&&&&&&&&&&&&&&&&&&############################################################
#####################&&&&&&&&&&&&&&&&&&&&&&&&&&&&&&&&&&############################################################
#####################&&&&&&&&&&&&&&&&&&&&&&&&&&&&&&&&&&############################################################
#####################&&&&&&&&&&&&&&&&&&&&&&&&&&&&&&&&&&############################################################
#####################&&&&&&&&&&&&&&&&&&&&&&&&&&&&&&&&&&############################################################
#####################&&&&&&&&&&&&&&&&&&&&&&&&&&&&&&&&&&############################################################
#####################&&&&&&&&&&&&&&&&&&&&&&&&&&&&&&&&&&############################################################
#####################&&&&&&&&&&&&&&&&&&&&&&&&&&&&&&&&&&############################################################
#####################&&&&&&&&&&&&&&&&&&&&&&&&&&&&&&&&&&############################################################
#####################&&&&&&&&&&&&&&&&&&&&&&&&&&&&&&&&&&############################################################
#####################&&&&&&&&&&&&&&&&&&&&&&&&&&&&&&&&&&############################################################
#####################&&&&&&&&&&&&&&&&&&&&&&&&&&&&&&&&&&############################################################
#####################&&&&&&&&&&&&&&&&&&&&&&&&&&&&&&&&&&############################################################
###################################################################################################################
###################################################################################################################
###################################################################################################################
###################################################################################################################
###################################################################################################################
###################################################################################################################
###################################################################################################################
###################################################################################################################
###################################################################################################################
###################################################################################################################
###################################################################################################################
###################################################################################################################
###################################################################################################################
###################################################################################################################
###################################################################################################################
###################################################################################################################
###################################################################################################################
###################################################################################################################
###################################################################################################################
###################################################################################################################
###################################################################################################################
###################################################################################################################
###################################################################################################################
###################################################################################################################
###################################################################################################################
###################################################################################################################
###################################################################################################################
###################################################################################################################
###################################################################################################################
###################################################################################################################
###################################################################################################################
###################################################################################################################
###################1111111111111111111111##########################################################################
###################1111111111111111111111##########################################################################
###################1111111111111111111111##########################################################################
###################1111111111111111111111##########################################################################
###################1111111111111111111111##########################################################################
###################1111111111111111111111##########################################################################
###################1111111111111111111111##########################################################################
###################1111111111111111111111##########################################################################
#####################################22222222222222222222222222222#################################################
#####################################22222222222222222222222222222#################################################
#####################################22222222222222222222222222222#################################################
#####################################22222222222222222222222222222#################################################
#####################################22222222222222222222222222222#################################################
#####################################22222222222222222222222222222#################################################
#####################################22222222222222222222222222222#################################################
#####################################22222222222222222222222222222#################################################
#####################################22222222222222222222222222222#################################################
#####################################22222222222222222222222222222#################################################
#####################################22222222222222222222222222222#################################################
#####################################22222222222222222222222222222#################################################
#####################################22222222222222222222222222222#################################################
#####################################22222222222222222222222222222#################################################
###################################################################################################################
###################################################################################################################
###################################################################################################################
###################################################################################################################
###################################################################################################################
###################################################################################################################
###################################################################################################################
###################################################################################################################
###################################################################################################################
###################################################################################################################
###################################################################################################################
###################################################################################################################
###################################################################################################################
###################################################################################################################
###################################################################################################################
###################################################################################################################
###################################################################################################################
###################################################################################################################
####################################################################################################################